5ive - Planet Be
A Made Up Sound - At Klangendum
Alex Humann - Isolated Rooms
Ali Khan - Lake
Alveol - Empty Heart
Andras - Poppy
Aphex Twin - ageispolis
Baaz - Endori (Dorisburg Remix)
Bambounou - Rai
Benedek - Westin
Black Loops - Badmanthing
Bodin - Sunup
Brando Lupi - Something Blue
Cosmonection - Carnaval
Dauwd - Analogische Memories
Deepbass - Battle For The Mind
Den Haas - Morning
Disasterpeace - Glitch
Donato Dozzy - Vetta Reprise
Dorisburg - Cirkla
Dwig - Way To Eden
El Huervo - Daisuke
Farben - Love To Love You Baby
Gramm - Type Zwei
Illuvia - Summer Rain
Impurity - Havana Laffe
Iron Curtis - Never Give Up (The Chant)
James Shinra - At The End Of The World
Jinsang - Wander
Jonathan Kusuma - Black Magic
Kassem Mosse - Untitled A3
K-Lone - Palmas
Leo Pol - House For The Soul
Low Orbit Satellite - Retrocyte
Martin Nonstatic - Hilarion
Martyne - TP Project
Monolake - Ping
Ness - An Encounter with Myself
Nicolas Jaar - Variations
Nikosf - A Matter of Shape
Omar S - Psychotic Photosynthesis (Original Mix)
pilotredsun - greetings
Playin' 4 The City - I'm Ready
Prince Ozay - Stelle marine
Purl - Behind Clouds
Retromigration - Don't Get Burned
Route 8 - Be Aware
Soichi Terada - Inside the Factory
Sun Araw - Deep Cover
Superlounge - Uluwatu Dub (Original Mix)
Sven Laux - PN-YD
Truncate - Minimize
Vanilla - Forgettin'
Vilod - Scheiss on Your Diamond
Zoo Look - The Reason